BACK	B AE K
DASA	D AA S AH
DASA(2)	D AE S AH
DOWN	D AW N
FORWARD	F AO R W ER D
HIGHER	HH AY ER
JET	JH EH T
LEFT	L EH F T
LOWER	L OW ER
MASSAGE	M AH S AA ZH
MODE	M OW D
OFF	AO F
ON	AA N
ON(2)	AO N
RAIN	R EY N
RESET	R IY S EH T
RIGHT	R AY T
SHOWER	SH AW ER
STOP	S T AA P
TEMPERATURE	T EH M P R AH CH ER
TEMPERATURE(2)	T EH M P ER AH CH ER
UP	AH P
